111111111111
1E0000000001
11100P000001
1C100000C001
111111111111