1111111111111
10000000000C1
100001111100
1P0011E000001
1111111111111